WWWWWWWWWWWWWWWWWWWWWWWWWxxx
W   W  W    W    W      WWxx
W   W                    WWx
W   W  W    W    W        WW
WW WW  WWWWWWWWWWW         W
W                          W
W                          W
W    WWW WWW               W
W    W     WWWW WW         W
WW WWW     W     W        WW
W    W           W       WWx
W    W     W     W      WWxx
WWWWWWWWWWWWWWWWWWWWWWWWWxxx